Map size: 10
61 31 101 69 62 18 89 56 37 46 
15 27 23 33 39 44 25 40 27 52 
97 42 23 72 60 45 82 21 48 69 
71 24 28 63 29 78 89 80 38 47 
30 60 82 24 35 63 50 26 22 79 
45 63 11 100 16 47 32 61 69 71 
87 45 101 56 74 35 21 24 27 80 
16 34 39 77 84 66 44 46 28 16 
39 101 82 75 23 40 53 16 26 49 
91 36 14 59 30 45 37 29 14 45 

16 35 99 71 39 59 88 48 91 24 
84 79 15 83 18 67 21 74 78 86 
40 24 82 40 95 16 75 55 59 90 
36 19 26 31 74 101 91 69 50 72 
47 54 90 48 16 69 77 23 96 53 
79 87 22 56 84 95 74 94 38 65 
55 101 15 46 13 41 36 38 62 63 
65 27 27 42 19 70 32 14 31 97 
42 26 82 28 41 18 39 66 49 27 
44 59 34 22 97 22 52 46 50 23 

63 46 86 53 16 18 78 39 13 32 
56 33 39 42 21 30 66 55 67 58 
32 72 96 99 36 42 24 19 97 57 
50 96 17 85 20 30 29 49 50 85 
38 91 32 38 79 34 98 81 79 17 
25 62 83 32 95 52 16 53 61 46 
55 38 88 38 98 30 55 70 44 30 
17 69 57 33 35 44 31 61 42 53 
61 17 86 95 86 26 34 15 31 38 
16 89 71 56 84 39 54 46 25 30 

105 79 31 70 18 58 43 26 14 90 
97 47 69 51 17 44 57 68 52 30 
49 70 16 60 37 64 56 65 69 61 
19 66 44 73 15 39 41 67 60 14 
30 88 33 79 37 43 62 70 79 19 
87 93 65 91 79 41 47 70 21 45 
39 87 46 30 49 55 19 67 62 28 
38 96 70 34 43 55 68 32 38 73 
71 73 62 80 20 56 18 42 29 60 
51 73 81 87 95 86 27 70 44 50 

27 100 83 67 89 31 49 26 52 20 
70 44 23 66 25 72 56 62 39 35 
42 72 59 60 47 53 13 62 12 13 
98 79 36 34 37 34 47 41 12 64 
74 74 94 58 88 46 59 55 17 95 
60 47 21 28 41 72 53 62 87 48 
87 26 87 78 60 18 73 66 15 25 
40 81 79 19 18 32 20 59 56 47 
43 55 28 21 29 61 11 80 69 47 
50 32 92 84 66 75 24 53 55 41 

96 71 102 61 66 56 19 98 77 51 
91 78 61 100 23 84 33 33 37 53 
101 31 22 44 38 22 26 73 58 83 
42 19 50 41 62 35 49 42 34 28 
43 65 69 33 16 64 19 62 64 32 
15 21 81 66 70 52 37 75 40 92 
85 73 87 91 65 16 50 34 19 25 
50 97 12 82 77 11 55 58 65 70 
31 80 64 75 16 100 90 27 82 63 
34 94 61 46 70 52 49 39 55 17 

92 32 88 49 33 37 16 104 44 75 
57 39 28 67 82 103 34 35 53 84 
13 86 41 103 29 90 44 31 30 66 
82 19 51 68 49 72 39 42 56 96 
102 72 24 63 72 46 83 18 102 17 
65 72 102 88 37 65 39 71 55 24 
36 80 58 96 83 61 59 85 104 50 
31 100 86 65 92 25 68 82 52 53 
69 77 16 89 67 92 58 68 64 41 
87 50 52 23 46 59 69 69 21 98 

39 73 40 70 61 11 80 100 44 70 
44 31 14 69 17 95 14 44 77 57 
40 57 101 39 66 92 46 62 81 20 
23 43 65 37 55 70 72 67 64 11 
86 38 27 36 37 52 50 14 94 40 
100 71 72 102 65 51 36 31 64 80 
74 39 18 52 43 31 69 88 85 18 
105 76 12 79 80 62 62 49 61 102 
67 36 64 81 51 32 86 35 23 30 
55 22 57 34 33 93 69 54 103 23 

97 98 52 67 28 71 71 71 48 89 
55 81 75 58 61 44 86 27 98 38 
58 58 25 57 10 97 23 71 35 49 
61 26 68 91 57 50 87 60 74 90 
82 63 60 15 102 12 37 60 26 90 
79 89 20 28 80 60 86 78 92 59 
102 87 28 43 56 32 33 54 84 11 
57 87 66 79 37 78 74 61 89 42 
27 97 65 54 27 22 40 38 50 93 
54 100 71 79 15 74 73 58 73 16 

77 72 19 94 88 49 80 100 88 51 
43 14 57 53 41 90 25 44 62 29 
35 47 24 84 49 51 49 15 102 72 
78 93 53 49 80 77 24 41 97 23 
32 31 74 95 66 19 67 18 60 16 
25 62 71 70 14 77 72 87 74 74 
70 92 93 86 52 67 56 22 80 57 
27 38 27 39 59 55 94 75 27 25 
35 23 34 99 20 51 42 87 33 73 
66 40 79 85 26 72 69 85 91 91 

