Map size: 10
59 29 97 64 89 15 86 54 35 44 
12 24 23 33 66 72 24 37 26 51 
91 42 23 99 86 43 76 19 45 67 
71 17 28 90 27 78 85 80 33 43 
25 59 76 21 34 62 47 25 19 77 
42 62 10 99 14 43 31 60 98 99 
86 43 98 56 72 31 18 20 55 78 
14 33 37 74 83 66 42 74 54 14 
38 99 81 75 20 38 53 45 25 45 
91 34 12 58 28 43 97 89 12 72 

16 33 99 71 96 87 85 47 90 23 
84 76 11 81 17 95 16 70 77 83 
39 20 80 38 95 14 74 52 56 88 
35 15 24 31 72 100 87 67 48 70 
43 50 89 47 15 68 76 22 95 51 
77 85 19 55 80 94 70 91 37 94 
54 97 15 45 10 37 35 35 56 62 
63 27 25 36 19 68 32 13 29 97 
38 23 81 26 39 15 34 61 78 25 
38 54 33 22 94 21 81 71 80 81 

62 43 85 49 43 17 75 34 11 31 
55 32 38 40 81 28 64 54 67 54 
31 71 93 94 32 42 24 17 96 55 
48 96 15 84 18 29 27 48 40 84 
34 90 30 35 79 34 97 78 79 17 
23 60 81 29 90 49 15 51 58 72 
52 37 86 35 96 30 53 97 72 28 
15 69 52 30 32 42 29 58 69 53 
58 11 84 93 84 24 31 13 88 66 
11 87 66 53 83 37 53 73 23 57 

100 79 28 99 44 87 71 24 14 89 
96 47 69 78 77 41 85 64 51 27 
49 68 13 59 36 89 86 65 66 61 
17 65 43 72 12 38 39 94 59 13 
29 81 29 76 36 39 62 95 76 18 
84 92 61 89 77 39 46 99 19 70 
36 86 43 27 44 53 14 94 59 54 
37 93 70 33 41 55 62 30 32 100 
69 73 60 78 18 56 16 41 54 54 
48 69 81 80 92 84 25 99 43 48 

22 99 79 64 87 31 77 22 50 17 
66 43 19 66 25 71 84 61 37 31 
41 67 57 58 42 82 10 59 10 11 
96 78 34 34 36 63 74 100 11 62 
71 73 91 55 85 75 88 81 16 91 
58 45 18 28 68 98 52 61 84 46 
83 23 84 76 58 18 70 65 12 24 
38 80 77 16 16 29 16 56 55 75 
42 52 26 18 26 60 10 79 98 46 
47 31 91 83 63 74 23 81 83 40 

95 70 99 57 64 54 12 95 76 48 
90 76 59 100 20 84 31 30 34 48 
99 28 16 43 37 20 24 66 55 80 
39 16 47 39 57 62 78 100 34 25 
39 61 68 26 14 93 19 60 63 30 
13 19 79 63 98 49 37 71 38 91 
84 70 85 91 93 14 49 33 19 24 
47 94 10 82 72 10 83 82 94 98 
30 77 59 70 14 100 88 27 80 63 
33 92 54 46 68 50 47 38 53 15 

90 30 87 45 30 33 14 100 40 71 
53 39 27 65 78 100 33 34 50 81 
12 85 41 97 23 89 43 27 28 63 
78 16 49 66 77 71 35 68 55 96 
100 70 23 61 97 43 81 17 100 17 
61 71 98 86 64 93 37 70 53 20 
32 76 56 93 81 89 87 82 100 45 
27 98 86 64 92 24 97 80 45 50 
68 75 14 87 65 92 54 68 63 40 
82 47 50 22 45 54 66 68 20 97 

37 72 39 68 59 11 80 97 42 70 
41 30 12 68 12 92 14 39 73 53 
38 55 100 38 60 90 45 60 77 17 
18 43 63 36 85 96 100 95 63 10 
82 38 27 35 34 50 50 12 94 39 
98 69 72 99 65 47 35 30 61 79 
68 35 16 50 43 29 99 87 79 17 
100 74 10 74 78 61 89 49 56 100 
64 34 61 79 48 29 85 32 21 30 
53 22 56 32 33 90 66 48 98 19 

96 91 50 65 26 66 69 68 45 88 
52 77 75 56 61 41 84 26 92 37 
58 54 25 53 10 96 22 70 35 49 
61 25 68 86 54 44 85 58 72 90 
81 59 59 10 97 11 35 59 24 88 
73 86 18 26 78 58 84 77 87 58 
96 82 26 42 53 27 30 51 82 10 
53 84 63 78 35 73 70 60 88 42 
27 95 62 51 27 18 38 35 50 92 
54 96 70 76 12 69 71 56 69 14 

76 70 17 89 84 45 79 97 87 48 
40 10 55 51 41 90 23 44 60 25 
32 44 22 78 45 49 48 14 99 72 
78 92 49 47 76 77 23 37 96 21 
30 30 71 91 63 18 63 15 58 14 
24 62 69 66 12 75 70 85 74 72 
67 89 90 83 49 65 53 19 76 53 
25 36 24 37 55 55 92 74 24 23 
33 23 32 95 16 49 41 84 30 71 
63 38 76 83 24 69 67 82 89 91 

